3
###################
#   #  o   o  #   #
#o#o# # ### # #o#o#
# #     #       # #
#o#o# # # # # #o#o#
#   #  o   o  #   #
# ### ###o### ### #
#      o   o#     #
### ### ### ### ###
# #o   o# #o    # #
### # # ### # # ###
#o   o#o   o#o   o#
# # # ### ### # # #
#        o        #
### # # # # # # ###
#   #o o#    o#   #
#o# # # ###o### # #
#                 #
###################
