6
###################
#  o   o   o   o  #
# ##### # # ##### #
#o   o  # #  o   o#
# ### ### ### ### #
# # #  o   o  # # #
# ### ####### ### #
#o  o         o  o#
#########o#########
#   o         o   #
# ####### ####### #
#  o    # #    o  #
# ##### # # ##### #
#     #  o  #     #
#o# #o#o# #o#o# #o#
# # #   # #   # # #
#o# ##### ##### #o#
#                 #
###################
