4
###################
#   #  o   o  #   #
#o#o# # ### # #o#o#
# #     #       # #
#o#o# # # # # #o#o#
#   #  o   o  #   #
# ### ###o### ### #
#      o   o#     #
### ### ### ### ###
# #o   o# #o   o# #
### # # ### # # ###
#o    #o   o#    o#
# # # ###o### # # #
#                 #
### # # # # # # ###
#o  #o o#o   o#  o#
# # # # ###o### # #
#                 #
###################
