2
###################
#      o   o      #
# # # # ### # # # #
#  o#o#  o  #o#o  #
# ### # ### # ### #
#      o   o      #
# # ### # # ### # #
# #  o  #o#  o  # #
# #o### # # ###o# #
#      o   o      #
# ### # ### # ### #
#  o#o#  o  #o#o  #
# # # # ### # # # #
#      o   o      #
# #o### # # ###o# #
# #  o  #o#  o  # #
# # ### # # ### # #
#                 #
###################
